42
20
100000000000000000000000000000000000000001
100001111000000000000000000000000000000001
100000000000000000000000000000000000000001
100000000000011100000000000000000000000001
100000000000010000000000000000000000000001
100000000000011111110000000011100000000001
100000000000000000000000000000000000000001
100000000000000000000000000000000100000001
100000000000000000000000000000000000000001
100000000000000000000000000000000000010001
100000000000000000000000000000000000000001
100000000000000000000000000000111000000001
100000000000000000000000000000000000000001
100000000011111000000000010000000000000001
100000000000000000000000000000000000000001
100000001111111000011000000000000000000001
100001000000000001000000000000000000000001
100000111000000011000000000000000000000001
100000111000111111000000000010000000000001
111111111111111111111111111111111111111111