20
20
00000000000000000000
00000000000000000000
00000000000000000000
00000000000000000000
00000000000000000000
00000000000000000000
00000000000000000000
00000000000000000000
00000000000000000000
00000000000000000000
00000000000000000000
00000000000000000000
00000000000000000000
00000000011111000000
00000000000000000000
00000001111111000000
00001000000000001000
00000111000000011000
00000111000111111000
11111111111111111111