40
20
0000000000000000000000000000000000000000
0000111100000000000000000000000000000000
0000000000000000000000000000000000000000
0000000000001110000000000000000000000000
0000000000001000000000000000000000000000
0000000000001111111000000001110000000000
0000000000000000000000000000000000000000
0000000000000000000000000000000010000000
0000000000000000000000000000000000000000
0000000000000000000000000000000000001000
0000000000000000000000000000000000000000
0000000000000000000000000000011100000000
0000000000000000000000000000000000000000
0000000001111100000000001000000000000000
0000000000000000000000000000000000000000
0000000111111100001100000000000000000000
0000100000000000100000000000000000000000
0000011100000001100000000000000000000000
0000011100011111100000000000000000000000
1111111111111111111111111111111111111111